0000000000110
0001111101110
0011000001110
0011000001110
0001111111111
