0,0,6,6,0,6,0,0,0,2,2,2,2,0,0,0,0,0,0,0,0,0,2,2,2,2,0,0,0,0,0,0,6,0,0,0,0,0,0,0,6,0,0,0,0,0,0,0,0,0,0,0,0,0,0,0,0,0,0,0,0,0,0,0,0,0,0,0,0,0,0,0,0,0,0,0,0,0,0,0,
0,0,0,0,0,0,0,0,0,2,2,2,2,0,0,0,6,0,0,6,0,0,2,2,2,2,0,0,0,0,6,0,0,0,6,0,0,0,0,0,0,0,0,0,0,6,6,0,0,0,0,4,4,4,4,4,4,4,4,4,4,4,4,4,4,4,4,4,4,4,4,4,4,4,4,4,4,0,0,0,
0,6,6,6,6,0,0,0,0,2,2,2,2,0,0,0,0,0,0,0,0,0,2,2,2,2,0,0,0,0,0,0,0,0,6,0,0,6,0,0,0,0,0,0,0,0,0,0,0,0,0,4,4,4,4,4,4,4,4,4,4,4,4,4,4,4,4,4,4,4,4,4,4,4,4,4,4,0,0,0,
0,0,6,6,6,6,0,0,0,2,2,2,2,0,0,0,0,0,0,0,0,0,2,2,2,2,0,0,0,0,0,0,6,0,6,6,0,0,0,0,0,6,0,0,0,0,0,0,0,0,0,4,4,4,4,4,4,4,4,4,4,4,4,4,4,4,4,4,4,4,4,4,4,4,4,4,4,0,0,0,
0,0,0,6,6,6,6,0,0,2,2,2,2,0,0,6,6,6,6,0,0,0,2,2,2,2,0,0,0,6,6,6,0,0,0,0,0,0,0,0,0,0,0,0,6,6,0,0,0,0,0,4,4,4,4,4,4,4,4,4,4,4,4,4,4,4,4,4,4,4,4,4,4,4,4,4,4,0,0,0,
0,0,0,0,0,0,0,0,0,2,2,2,2,0,6,6,6,6,6,6,0,0,2,2,2,2,0,0,0,6,0,0,0,0,0,0,0,0,0,0,0,0,0,0,0,0,0,0,0,0,0,4,4,4,4,4,4,4,4,4,4,4,4,4,4,4,4,4,4,4,4,4,4,4,4,4,4,0,0,0,
0,0,0,0,0,0,0,0,0,2,2,2,2,0,6,6,6,6,6,6,0,0,2,2,2,2,0,0,0,6,0,0,0,0,4,4,4,4,4,4,4,4,4,4,4,4,4,0,6,0,0,4,4,4,4,4,4,4,4,4,4,4,4,4,4,4,4,4,4,4,4,4,4,4,4,4,4,0,0,0,
0,0,0,0,0,0,0,0,0,2,2,2,2,0,0,6,6,6,6,0,0,0,2,2,2,2,0,0,0,6,0,0,0,0,4,4,4,4,4,4,4,4,4,4,4,4,4,0,0,0,6,4,4,4,4,4,4,4,4,4,4,4,4,4,4,4,4,4,4,4,4,4,4,4,4,4,4,0,0,0,
0,0,0,0,0,0,0,0,0,2,2,2,2,0,0,0,0,0,0,0,0,0,2,2,2,2,0,0,0,6,0,0,0,0,4,4,4,4,4,4,4,4,4,4,4,4,4,6,0,0,0,4,4,4,4,4,4,4,4,4,4,4,4,4,4,4,4,4,4,4,4,4,4,4,4,4,4,0,0,0,
0,0,0,0,0,0,0,0,0,2,2,2,2,0,0,0,0,0,0,0,0,0,2,2,2,2,0,0,0,0,0,0,0,0,4,4,4,4,4,4,4,4,4,4,4,4,4,0,0,6,0,4,4,4,4,4,4,4,4,4,4,4,4,4,4,4,4,4,4,4,4,4,4,4,4,4,4,0,0,0,
0,0,0,0,0,0,0,0,0,2,2,2,2,0,0,0,0,0,0,6,0,0,2,2,2,2,0,0,0,0,0,0,0,0,4,4,4,4,4,4,4,4,4,4,4,4,4,0,0,0,0,4,4,4,4,4,4,4,4,4,4,4,4,4,4,4,4,4,4,4,4,4,4,4,4,4,4,0,0,0,
0,0,0,0,0,0,0,0,0,2,2,2,2,0,0,0,0,0,0,6,0,0,2,2,2,2,0,0,0,0,6,6,0,0,4,4,4,4,4,4,4,4,4,4,4,4,4,0,0,6,0,4,4,4,4,4,4,4,4,4,4,4,4,4,4,4,4,4,4,4,4,4,4,4,4,4,4,0,0,0,
0,0,0,0,0,0,0,0,0,2,2,2,2,0,0,0,0,0,0,0,0,0,2,2,2,2,0,0,0,0,0,0,0,0,4,4,4,4,4,4,4,4,4,4,4,4,4,0,6,0,0,4,4,4,4,4,4,4,4,4,4,4,4,4,4,4,4,4,4,4,4,4,4,4,4,4,4,0,0,0,
0,0,0,0,0,0,0,0,0,2,2,2,2,0,0,0,0,0,0,0,0,0,2,2,2,2,0,0,6,0,0,0,0,0,4,4,4,4,4,4,4,4,4,4,4,4,4,0,0,0,0,4,4,4,4,4,4,4,4,4,4,4,4,4,4,4,4,4,4,4,4,4,4,4,4,4,4,0,0,0,
0,0,0,0,0,0,0,0,0,2,2,2,2,0,0,0,0,6,0,0,0,0,2,2,2,2,0,0,0,0,0,0,0,0,4,4,4,4,4,4,4,4,4,4,4,4,4,0,0,6,0,4,4,4,4,4,4,4,4,4,4,4,4,4,4,4,4,4,4,4,4,4,4,4,4,4,4,0,0,0,
0,0,0,0,0,0,0,0,0,2,2,2,2,0,6,0,0,0,0,0,0,0,2,2,2,2,0,0,0,0,6,0,0,0,4,4,1,1,1,1,1,1,1,1,1,4,4,0,0,0,0,4,4,4,4,4,4,4,4,4,4,4,4,4,4,4,4,4,4,4,4,4,4,4,4,4,4,0,0,0,
0,0,0,0,0,0,0,0,0,2,2,2,2,0,0,0,0,0,0,0,0,0,2,2,2,2,0,0,0,0,0,0,0,0,b,1,1,1,1,1,1,1,1,1,1,1,a,0,0,0,0,6,6,6,0,0,0,0,0,0,0,0,1,1,1,1,0,0,0,0,0,0,0,0,0,0,0,0,0,0,
9,9,9,9,9,9,9,9,9,1,1,1,1,9,9,9,9,9,9,9,9,9,1,1,1,1,9,9,9,9,9,9,9,9,1,1,1,1,1,1,1,1,1,1,1,1,1,9,9,9,9,9,9,9,9,9,9,9,9,9,9,9,1,1,1,1,9,9,9,9,9,9,9,9,9,9,9,9,9,9,
1,1,1,1,1,1,1,1,1,1,1,1,1,1,1,1,1,1,1,1,1,1,1,1,1,1,1,1,1,1,1,1,1,1,1,1,1,1,1,1,1,1,1,1,1,1,1,1,1,1,1,1,1,1,1,1,1,1,1,1,1,1,1,1,1,1,1,1,1,1,1,1,1,1,1,1,1,1,1,1,
1,1,1,1,1,1,1,1,1,1,1,1,1,1,1,1,1,1,1,1,1,1,1,1,1,1,1,1,1,1,1,1,1,1,1,1,1,1,1,1,1,1,1,1,1,1,1,1,1,1,1,1,1,1,1,1,1,1,1,1,1,1,1,1,1,1,1,1,1,1,1,1,1,1,1,1,1,1,1,1,
8,8,8,8,8,8,8,8,8,8,8,8,8,8,8,8,8,8,8,8,8,8,8,8,8,8,8,8,8,8,8,8,8,1,1,1,1,1,1,1,1,1,1,1,1,1,1,1,1,8,8,8,8,8,8,8,8,8,8,8,8,8,8,8,8,8,8,8,8,8,8,8,8,8,8,8,8,8,8,8,
0,0,0,0,0,0,0,0,0,0,0,0,0,6,6,6,6,0,0,0,0,0,0,0,0,6,0,6,0,0,0,0,0,b,1,1,1,n,j,j,j,j,j,o,1,1,1,1,a,0,0,0,0,0,0,0,0,0,0,0,0,0,0,0,6,6,0,0,0,0,0,6,0,0,0,0,0,0,0,0,
0,0,0,0,0,0,0,0,0,0,0,0,0,0,0,0,0,0,0,0,0,0,0,0,0,0,0,6,0,0,0,0,0,b,1,1,1,i,5,5,5,5,5,k,1,1,1,1,a,0,0,0,0,0,0,0,0,0,0,0,0,0,0,0,0,0,0,0,0,0,0,6,0,0,0,0,0,0,0,0,
0,0,0,6,0,6,6,6,0,0,0,0,0,0,0,0,0,0,0,0,0,4,4,4,4,4,4,0,0,0,0,0,0,b,1,1,1,i,5,5,5,5,5,k,1,1,1,1,a,0,0,4,4,4,4,4,4,4,4,0,0,0,0,0,0,0,6,0,0,6,0,0,0,0,0,0,0,0,0,0,
6,0,6,0,0,0,0,0,6,0,0,0,0,0,0,0,0,0,0,0,0,4,4,4,4,4,4,0,0,0,6,0,6,b,1,1,1,i,5,5,5,5,5,k,1,1,1,1,a,0,0,4,4,4,4,4,4,4,4,0,0,0,0,0,0,6,6,6,6,0,0,0,0,0,0,0,0,0,0,0,
0,0,0,0,0,0,0,0,0,0,0,0,0,0,0,0,0,0,0,0,0,4,4,4,4,4,4,0,0,0,0,0,0,b,1,1,1,m,h,h,h,h,h,l,1,1,1,1,a,0,0,4,4,4,4,4,4,4,4,0,6,0,0,0,0,0,0,0,0,6,6,0,0,0,0,0,0,0,0,0,
0,0,0,0,0,0,0,0,0,0,6,6,6,6,0,0,0,0,0,0,0,4,4,4,4,4,4,0,0,6,6,0,0,b,1,1,1,1,1,1,1,1,1,1,1,1,1,1,a,0,0,4,4,4,4,4,4,4,4,0,0,0,6,0,0,0,0,0,0,0,0,0,0,0,0,0,0,0,0,0,
0,0,0,0,0,0,0,0,0,0,0,0,0,0,0,0,0,0,0,0,0,4,4,4,4,4,4,0,0,0,0,0,0,b,1,1,1,1,1,8,8,8,1,1,1,1,1,1,a,0,0,4,4,4,4,4,4,4,4,0,0,0,0,6,0,6,0,0,0,0,6,6,0,6,0,0,0,0,0,0,
2,2,2,2,2,2,2,2,0,0,0,0,0,0,6,0,0,0,0,0,0,4,4,4,4,4,4,0,0,0,0,0,0,b,1,1,1,1,r,0,6,0,s,1,1,1,1,1,a,0,0,4,4,4,4,4,4,4,4,0,0,0,0,0,0,0,6,6,0,0,0,6,0,0,6,0,0,0,0,0,
2,2,2,2,2,2,2,2,2,2,2,2,2,2,0,6,6,0,0,0,0,0,0,0,0,0,0,0,0,0,0,0,0,b,1,1,1,r,0,0,0,0,0,s,1,1,1,1,a,0,0,0,0,0,0,0,4,4,4,0,0,0,0,0,0,0,0,6,0,0,6,0,0,6,0,0,0,0,0,0,
2,2,2,2,2,2,2,2,2,2,2,2,2,2,2,2,0,0,6,0,6,6,0,0,0,0,0,0,0,0,0,0,0,b,1,1,a,0,0,0,0,0,0,6,b,1,1,1,a,0,0,0,0,0,0,0,4,4,4,0,0,0,0,0,0,0,0,0,6,6,0,0,6,0,0,6,0,6,0,0,
2,2,2,2,2,2,2,2,2,2,2,2,2,2,2,2,2,2,2,0,0,0,6,0,0,0,0,0,0,0,0,0,0,b,1,1,a,6,0,0,0,0,0,0,b,1,1,1,a,0,0,0,6,0,0,0,4,4,4,0,0,0,0,0,0,6,0,0,0,0,6,0,0,0,0,0,0,0,0,0,
5,5,5,5,2,2,2,2,2,2,2,2,2,2,2,2,2,2,2,2,2,0,0,6,0,0,0,0,0,0,0,0,0,b,1,1,a,0,0,0,0,0,0,0,b,1,1,1,a,0,0,0,0,0,0,0,0,0,0,0,0,0,6,0,0,0,0,0,0,0,6,6,6,0,0,0,0,0,0,0,
5,5,5,5,5,5,5,2,2,2,2,2,2,2,2,2,2,2,2,2,2,2,2,0,6,6,0,0,0,0,0,0,0,b,1,1,a,0,0,0,6,6,0,6,b,1,1,1,a,0,0,0,0,0,0,0,0,0,0,0,0,0,0,0,0,0,0,0,0,0,0,0,6,6,0,0,0,0,0,0,
5,5,5,5,5,5,5,5,2,2,2,2,2,2,2,2,2,2,2,2,2,2,2,2,0,0,6,0,0,0,0,0,0,b,1,1,a,0,0,0,0,0,0,0,b,1,1,1,a,0,0,0,0,0,0,6,0,0,0,0,0,0,0,6,6,0,0,0,0,0,0,0,0,0,0,0,0,0,0,0,
5,5,5,5,5,5,5,5,5,5,2,2,2,2,2,2,2,2,2,2,2,2,2,2,0,0,0,6,0,0,0,0,0,b,1,1,a,0,0,0,0,6,6,0,b,1,1,1,1,9,9,9,9,9,9,9,9,9,9,9,9,9,9,9,9,9,9,9,9,9,9,9,9,9,9,9,9,9,9,9,
5,5,5,5,5,5,5,5,5,5,5,2,2,2,2,2,2,2,2,2,2,2,2,2,0,0,0,0,0,0,0,0,0,b,1,1,a,0,0,4,4,4,0,0,b,1,1,1,1,1,1,1,1,1,1,1,1,1,1,1,1,1,1,1,1,1,1,1,1,1,1,1,1,1,1,1,1,1,1,1,
5,5,5,5,5,5,5,5,5,5,5,2,2,2,2,2,2,2,2,2,2,2,2,2,2,6,0,0,0,6,0,0,0,b,1,1,a,0,0,4,4,4,0,0,b,1,1,1,1,1,1,1,1,1,1,1,1,1,1,1,1,1,1,1,1,1,1,1,1,1,1,1,1,1,1,1,1,1,1,1,
5,5,5,5,5,5,5,5,5,5,5,5,2,2,2,2,2,2,2,2,2,2,2,2,2,0,0,0,6,0,0,0,0,b,1,1,a,0,0,4,4,4,0,0,b,1,1,1,1,1,1,1,1,1,1,1,1,1,1,1,1,1,1,1,1,1,1,1,1,1,1,1,1,1,1,1,1,1,1,1,
5,5,5,5,5,5,5,5,5,5,5,5,2,2,2,2,2,2,2,2,2,2,2,2,2,6,0,0,0,0,0,0,0,b,1,1,a,0,0,0,0,0,0,0,b,1,1,1,1,8,8,8,8,8,8,8,8,8,8,8,8,8,8,8,8,8,8,8,8,8,8,8,8,8,8,8,8,8,8,8,
5,5,5,5,5,5,5,5,5,5,5,5,2,2,2,2,2,2,2,2,2,2,2,2,0,6,0,0,0,0,0,0,0,b,1,1,a,0,0,0,6,6,0,6,b,1,1,1,a,0,0,0,0,0,0,0,0,0,0,0,0,0,0,0,0,0,0,0,0,0,0,0,6,6,0,0,0,0,0,0,
5,5,5,5,5,5,5,5,5,5,5,2,2,2,2,2,2,2,2,2,2,2,2,0,6,6,0,0,0,0,0,0,0,b,1,1,a,0,0,0,6,6,0,6,b,1,1,1,a,0,0,0,0,0,0,0,0,0,0,0,0,0,0,0,0,0,0,0,0,0,0,0,6,6,0,0,0,0,0,0,
5,5,5,5,5,5,5,5,5,5,2,2,2,2,2,2,2,2,2,2,2,2,2,0,6,6,0,0,0,0,0,0,0,b,1,1,a,0,0,0,6,6,0,6,b,1,1,1,a,0,0,0,0,0,0,0,0,0,0,0,0,0,0,0,0,0,0,0,0,0,0,0,6,6,0,0,0,0,0,0,
5,5,5,5,5,5,5,5,5,2,2,2,2,2,2,2,2,2,2,2,2,2,0,0,6,6,0,0,0,0,0,0,0,b,1,1,a,0,0,0,6,6,0,6,b,1,1,1,a,0,0,0,0,0,0,0,0,0,0,0,0,0,0,0,0,0,0,0,0,0,0,0,6,6,0,0,0,0,0,0,
5,5,5,5,5,5,5,5,2,2,2,2,2,2,2,2,2,2,2,2,2,0,0,0,6,6,0,0,0,0,0,0,0,b,1,1,a,0,0,0,6,6,0,6,b,1,1,1,a,0,0,0,0,0,0,0,0,0,0,0,0,0,0,0,0,0,0,0,0,0,0,0,6,6,0,0,0,0,0,0